%%%%%%%%%%%%%%%%%%%%%%%%%
%                       %
% %%%%% %%%%%% %%%%%%%% %
% %%     %   % %.     % %
% %% %%% %%% % %%%% %%% %
% %%           %     %% %
% %% %%% %%  %%% %%%%%% %
% %         %%%   .     %
% %%% %%%%% %%%  %%%%%% %
% %.         %%%     %% %
%   %%%%%%%%      %%%%%%%
%%%%%        %%%%       %
%      %%%%%    %%    %%%
% %%%%%%        %%%%   .%
%P       %%%%%%       %%% 
%%%%%%%%%%%%%%%%%%%%%%%%%
